11111111111111111111
10000000000000000000
10000010000000000q00
10000000000000000000
10000000000001000000
10001000000000000000
10001000022200000000
10011110000000000000
100000110q0qqqqq0010
10000100000000000000
