11111111111111111111
1000000000000e000000
10000010000000000q00
10000000000000000000
10000000000001000000
10003000000000000000
10000000022200000w00
10011110000000000000
100000110000wq000010
10000100000000000000
