11111111111111111111
10000000000000000000
10000010000000000000
10000000000000000000
10000000000001000000
10001000000000000000
10001000022200000000
10011110000000000000
10000011000000000010
10000100000000000000
