100000000000001000q0
10000000000000000000
10111111111111000000
10000000000000000000
100000000000w1000000
100010q0000000000000
10001000022200000000
1001111000000w00q000
100e0011000000000010
100e0100000000000000
