11111111111111111111
00000000000000000000
00111111111111000000
00000000000000000000
02222222000001000000
00001000222222000000
00001000022200222200
00011110000000000020
00000011000000000012
00000100000000000000
