11111111111111111111
00000000000000000000
00000111111111000000
00000000000000000000
0002220000q000000000
00001000222222000000
00000000022200222200
00011110000000000020
00000011000000000010
00000000000000000000
