00000000000000000000
00000000000000000000
00000000000000000000
00000001000000000000
02222222100001000000
00001000122222000011
00001000011200222100
00011110000100011020
00000011000010100012
00000100000001000000
