00000000000000000000
00000000000000000000
00000000000000000000
000000010000w0000000
02222222100001000000
000010001222220e0010
00001000011200222100
00011110000100011020
00000011000010100010
00000000000000000000
