00000000000000000000
00000000000100000000
00000000000100000000
00000001000000000000
00000000000001110100
00000000000000101010
000011000100w0100100
00010000000000111020
00000001000000100010
11111111111111111111
