00000000000000000000
00000000000100000000
00000000000100000000
00000001000000000000
00000000000001110100
00000000000000101011
00001100010000100100
00010000000000111020
00000001000000100012
11111111111111111111
