11111111111111111111
00000000000000000001
00000000000000000001
00000011111100000001
00000010001010000001
00000000001001000001
00000001000100110001
00000010000100010101
00000000000000011001
00000100000000000001
