00000000000000000001
00000000000000000001
00000000001110000001
00000000001001100001
00000010111000011111
00000000001111100001
00000001011100100001
00000010200000011111
00000002000000000001
00000100000000000001
