00000000000000000001
00000000000000000001
01000000001000000001
00100000001001100001
000122100q0200210011
00000010001000000001
00000201111100200001
00000110200001001021
00000002000000100001
11111111111111111111
